7 7
###0###
#00000#
#0###0#
#00000#
#0###0#
#00000#
###0###
